pirateid Adam.Cernoch	&mdash;
pirateid Adam.Hobza	&mdash;
pirateid Adam.Janik	NQI7Kk040YIcTl3pm3xkV5BDsCYmftXmnnY1hi9Blss [zobrazit]
pirateid Adam.Jaros	pvmqyxci+FAJ1AcwKSRfWa61vDhVdMRIgejvpd6SnbQ [zobrazit]
pirateid Adam.Kheil	&mdash;
pirateid Adam.Komenda	&mdash;
pirateid Adam.Kopetzky	&mdash;
pirateid Adam.Slamenik	&mdash;
pirateid Adam.Valenta	J0vy2mlx/rktEf07VGknst2DQyI6DBcVKxe+HV5BgYM [zobrazit]
pirateid Adam.Vales	&mdash;
pirateid Adam.Vyplel	BJ/nXzOTgHKiWf6BrnRdsrrBLZu9hjJJUfmT6pyknqk [zobrazit]
pirateid Adam.Zabransky	&mdash;
pirateid Albert.Diok	&mdash;
pirateid Alena.Dvorakova	&mdash;
pirateid Alena.Klocova	&mdash;
pirateid Alena.Pavlasova	/67767IXfzwpVICO3J0qhp4rGxPJ6AMvyY6lo+T4BRU [zobrazit]
pirateid Ales.Jakl	UOpaN3TEXOAjm/aByBYESSAHT2rBQgxytJq8aLVSiwE [zobrazit]
pirateid Ales.Kosina	ecClDLhKUFkezeEhYL31ioaKrOE7z7WitnPQJYMewz0 [zobrazit]
pirateid Ales.Nunvar	&mdash;
pirateid Ales.Stibal	&mdash;
pirateid Ales.Sura	&mdash;
pirateid Ales.Valnoha	&mdash;
pirateid Alexander.Harvan	&mdash;
pirateid Alexandr.Mansurov	&mdash;
pirateid Alice.Hamalova	dz/4BpiuV88gqxEldv4V+SuBgctIwuz696U8m33Zx5Y [zobrazit]
pirateid Andrea.Hoffmannova	&mdash;
pirateid Andrea.Linhartova	1tMUCk8PY8ekMzgwquvv0dSUjLMz5P7+teR1x+nOyh4 [zobrazit]
pirateid Andrea.Mareckova	2bBNeYYvjhwx/q+QtJsUGYKrjTmizFNWtg43ofGFt4g [zobrazit]
pirateid Andrea.Protivinska	LAtWbivTF4CgywS8fusZgVakshBlCdkgpoaH9Ccl9Qk [zobrazit]
pirateid Andrej.Ramaseuski	aXnXCv81TyhSWDp9fVPxx7aeYDEr0CApZai0PmjKKc8 [zobrazit]
pirateid Aneta.Heidlova	haB0nhEck4h8T93xc+2xw9TjDXPXiHBEyiTXm2qyEoU [zobrazit]
pirateid Aneta.Matejkova	&mdash;
pirateid Anna.Filinova	IcqX/cbLKdyNGsTNdBmrZEn6yH8UEfwEO/r/bZml6qA [zobrazit]
pirateid Anna.Kratochvilova	&mdash;
pirateid Anna.Ungerova	&mdash;
pirateid Anna.Vavreckova	&mdash;
pirateid Antonin.Klejzar	&mdash;
pirateid Antonin.Schejbal	&mdash;
pirateid Antonin.Stepan	&mdash;
pirateid Antonin.Stogr	Yj2yhMVVHeARi+W2eJZ8s1lsvLtbKRrnEVJiRS2oSNU [zobrazit]
pirateid Arja.Karimbasharyarova	&mdash;
pirateid Arnost.Stepanek	&mdash;
pirateid Barbora.Erbenova	Nj5wZly0rVtLfxI6bvir5lXgUgOGMBOgqaN0aoOpaug [zobrazit]
pirateid Barbora.Hradecna	&mdash;
pirateid Barbora.Hruzova	NqGQsxu2QiOBAEj12HoqC0kDy9LcDr/+4h30O/RNuIc [zobrazit]
pirateid Barbora.Chvalova	&mdash;
pirateid Barbora.Stankova	&mdash;
pirateid Barbora.Stuchla	&mdash;
pirateid Barbora.Vojkovska	&mdash;
pirateid Barbora.Wirnitzerova	&mdash;
pirateid Bohdana.Hola	GRa2Pz4nfXkjMptB5GqTZt60F0Bk2I/TfhZU/moZmd0 [zobrazit]
pirateid Bohdan.Garstka	&mdash;
pirateid Dalibor.Jandik	&mdash;
pirateid Dalibor.Zahora	NRNYL20f3posRHU/0JKSJEY8+xbCCXux3Yz6M+kcBjw [zobrazit]
pirateid Damian.Waloszek	&mdash;
pirateid Dana.Balcarova	Dh7xPPfOqd7eOvDdkRVMhoFlkeX/xG11f02atqFwBVI [zobrazit]
pirateid Daniela.Bila	Nh6gSlDuPFRzumsS1LRF26XSPoyZqTRXsIzB4aZOrFo [zobrazit]
pirateid Daniela.Lakatosova	&mdash;
pirateid Daniela.Nova	&mdash;
pirateid Daniela.Weissova	2cCtGloCQdXpkk/xH+IblRQ5yOQabiLKB0M5338iW7E [zobrazit]
pirateid Daniel.Duska	&mdash;
pirateid Daniel.Farkas	&mdash;
pirateid Daniel.Galuszka	T6KOWQbLIGqOBE06biVoMfhCSDDKzfdLW2pNYzoLELA [zobrazit]
pirateid Daniel.Halamicek	3EX20+tufKsymnKuLiYDH1vuabzvmrAh5yYWLM9qqYE [zobrazit]
pirateid Daniel.Komenda	&mdash;
pirateid Daniel.Kus	Vz3U5Ti5iSWjJa36zBUK0UgFMgaKPvAtdM7UYNy4yPw [zobrazit]
pirateid Daniel.Lebduska	R0lKikeOax8EPQRL8Iu6fURWbD08B22THM4UaGnta8w [zobrazit]
pirateid Daniel.Mazur	&mdash;
pirateid Daniel.Nadvornik	&mdash;
pirateid Daniel.Netusil	&mdash;
pirateid Daniel.Prim	&mdash;
pirateid Daniel.Sosyn	&mdash;
pirateid Dan.Lestina	f8UGhQaZA5CAtz7H664eJaLyPQXK5lpaxJTX6Wgkgo0 [zobrazit]
pirateid David.Bodecek	&mdash;
pirateid David.Drobny	6yhWTDawlIxviHOHG14IpE9kll0252DqigbTNJeC3Wk [zobrazit]
pirateid David.Hosek	R9Bao+3us9ffbsY+qTvn3jqx+vZrk9o5+A3EW2oJyt8 [zobrazit]
pirateid David.Marhold	&mdash;
pirateid David.Novak	&mdash;
pirateid David.Rejha	&mdash;
pirateid David.Satke	CaQrEQC1bdG6s5EkZQqd+t8/7n5UkdBshMgrxjJKp9w [zobrazit]
pirateid David.Schindler	&mdash;
pirateid David.Wagner	VWI05ztUBFma0Vz66viyEPoFxRljF6S9NUCsHSKdx0Y [zobrazit]
pirateid David.Witosz	URfidTd75qLgN9p5X/6aPoDo/Z5SXvPY7nnKwBIy/qc [zobrazit]
pirateid Denisa.Kucerova	&mdash;
pirateid Denis.Rychtar	&mdash;
pirateid Deny.Krejci	&mdash;
pirateid Denys.Luksik	&mdash;
pirateid Dino.Arnautovic	&mdash;
pirateid Dominika.Michailidu	&mdash;
pirateid Dominik.Becka	cTeegawF4iVQyEsQCcQ456tdHcwEcjDOaeq+06JNGNI [zobrazit]
pirateid Dominik.Burget	&mdash;
pirateid Dominik.Srnensky	&mdash;
pirateid Dominik.Vorac	&mdash;
pirateid Dusan.Hanus	&mdash;
pirateid Dusan.Jurcik	pwT1FU8+LC3tUGSfx97RLRtjsj+WMnEbZdnBiXu9Edw [zobrazit]
pirateid Dusan.Plch	kVdUjv4N1pP8EHzhsSJbGJFRZHbCBlRaA7m9ir4hpyg [zobrazit]
pirateid Eduard.Horak	&mdash;
pirateid Eliska.Duskova	&mdash;
pirateid Eliska.Holsanova	&mdash;
pirateid Eliska.Polochova	&mdash;
pirateid Elizabet.Kovaceva	&mdash;
pirateid Eric.Liam.Bibikov	m7e1coAQ5Dg+4olFVIVCS8w6pVaQoj51RKLK+7YoDSs [zobrazit]
pirateid Eva.Horakova	sqXy03KybiUsJ82+CUBGZAIQt/EbN8Rf2MFRQz1yE3U [zobrazit]
pirateid Eva.Novakova	c8CNidyzS8QZEJEyO/RlqceULiVd8NvWC6+xjv6vxEU [zobrazit]
pirateid Eva.Stankova	18PAwpP2ZOvLk04hBiAwXsnZ3EnLM80WRMcXOpaYegI [zobrazit]
pirateid Eva.Ticha	uKMsZZf8KyaNiE6oCN6MSeORmvQUioHJiexOsZIlOf8 [zobrazit]
pirateid Evzen.Boura	&mdash;
pirateid Filip.Dite	mlADMCRYyn/ixpPY1jMkdNWA1UVxuYOwFff43zsE1zY [zobrazit]
pirateid Filip.Kavan	&mdash;
pirateid Filip.Krska	&mdash;
pirateid Filip.Mastnik	wv7vmYzhP1JBFuuly/wf091SgjWoOr5abi0esisRe4U [zobrazit]
pirateid Filip.Matuska	2Lzik423CRTRvubSOrhNKQPZE1nQmmqrYGLJXvo++Rg [zobrazit]
pirateid Filip.Mezera	V5qbUsgS6Hm2JEUdw+MnJ+Cuu7sGHe9yVx7EC0T5ne0 [zobrazit]
pirateid Filip.Miler	&mdash;
pirateid Filip.Sequens	lz5T2+UhAgX+QZ0zmWAIcZYFeGdi07AtDNtuSCmCF0A [zobrazit]
pirateid Filip.Smoljak	fSzI5FB7jo7GWquKfSVU6vtoIu3irEgOJ9++zmtROZk [zobrazit]
pirateid Filip.Varecha	banHZW1VLBTYF/N8VGjQJZjyTMM7opN9erzu1mt29RA [zobrazit]
pirateid Frantisek.Dosedel	&mdash;
pirateid Frantisek.Hagara	CeetCmG+GyNZbTuX08su03ngYkP0XpHOu4EBA71L1RQ [zobrazit]
pirateid Frantisek.Kindl	LeC9rDwfz//R/I8DCAdpRRnQi+6lKKAtvocSVXYFCzQ [zobrazit]
pirateid Frantisek.Kopriva	2hteL4PmOxKDUDRGCKO9qEa69mBv8gBOGiPPIZyFsL0 [zobrazit]
pirateid Frantisek.Navrkal	6vFSc7GxF0/biVKwELzsBuG8qOSW49F6/7/bI3IURv8 [zobrazit]
pirateid Frantisek.Pudil	&mdash;
pirateid Gabriela.Lnenickova	+k4O7+3SlobBTt2SO/2NuRcrj11lERHmTI2g4/unvvM [zobrazit]
pirateid Gabriela.Maceckova	&mdash;
pirateid Georgia.Hejduk	PCbByEZE+3RUKpL8HlmlN/h5iAvaW20kZlZvnSyFsKw [zobrazit]
pirateid Giuseppe.Maiello	cy8JiXZie65927lPlpRItzRrkMqb6QbpPawxgspglTE [zobrazit]
pirateid Hana.Ancincova	6cO9I+BIqmMPyOy1zrNjImG56Rh+7gegxXzd4tak/BM [zobrazit]
pirateid Hana.Brnakova	&mdash;
pirateid Hana.Hajnova	ux0tpVi0mIC+Ofychao979SOHTsCCZ1Hw20EceoEBmY [zobrazit]
pirateid Hana.Chalusova	&mdash;
pirateid Hana.Porubova	&mdash;
pirateid Hana.Vodrazkova	CCJQuNkiqWlBJwEicf2WbcoFOJ8X/3RSuB+ERVLIupw [zobrazit]
pirateid Helena.Machovcova	&mdash;
pirateid Helena.Vondrakova	FlTq0gJRBK/P/DyL7PcI/nOPkt4p1YRoYEGiQUczwds [zobrazit]
pirateid Honza.Dvorak	&mdash;
pirateid Honza.Hora	Aa0uNDOjfLbwRjiglz7OkvV31FyTW/Glpz2jQJi50/g [zobrazit]
pirateid Horak.Jakub	jgjzMoq+RpylzJOlFE3FX4qJxNpkL2Y+AAimwUnZ18w [zobrazit]
pirateid Hynek.Kliment	&mdash;
pirateid Hynek.Melichar	Dz5ekkNn/ukUTNqmYuJTOhSd/ReABOMcku8SkiT5Gbg [zobrazit]
pirateid Hynek.Polasek	&mdash;
pirateid Ida.Chuchlikova	eZzn6CiPY9zMPSvymHmSfYM5+Zjp+cjWGtq5vbdcGzg [zobrazit]
pirateid Irena.Drofova	38Tk/AGyv1cpeiKjudSlRalElBiN1cypfqnqx0AZZKg [zobrazit]
pirateid Irena.Kubatova	&mdash;
pirateid Ireneusz.Pieniazek	&mdash;
pirateid Iva.Dvorakova	cc3B2Y9GBLlUMaZ8ISBg0e1LWqYgYha7ZbPQIqGnCD8 [zobrazit]
pirateid Ivana.Bohmova	pihBQ0tyVtymDcKkcKxY90xtJjBE+z3c7DX1ZSx3XY4 [zobrazit]
pirateid Ivan.Bartos	&mdash;
pirateid Ivan.Hruza	&mdash;
pirateid Ivan.Jurka	&mdash;
pirateid Ivan.Mikolas	&mdash;
pirateid Ivan.Muzik	nPLappc4f8LlHRYj/vbbyrnOCYS6pvhaxqEgzXvXGyE [zobrazit]
pirateid Iveta.Lysonkova	&mdash;
pirateid Iveta.Pospisilova	SfqPw2Pesspb2/nekFQ8F3Kkliq6m4ZkXt3zqv2Rucw [zobrazit]
pirateid Ivo.Fischer	&mdash;
pirateid Ivor.Kollar	53N4KLvW6bVtuyCSl/bEuUMxi8VlLiGcsEP4BYjei80 [zobrazit]
pirateid Ivo.Slavka	rQcAFLPRbDdy3YrqxvAemdN+59KTQCCT8hKCc7lPDio [zobrazit]
pirateid Ivo.Vasicek	&mdash;
pirateid Ivo.Vlasaty	MM5Iiw37NMIoc+BCK8K6lfuFr0iqcrqkDm1bcrSXaGQ [zobrazit]
pirateid Jakub.Dedek	Xlrrs5XbQuPMWn54FDAQkhLkmR1NyBKrok7fMBZuVMo [zobrazit]
pirateid Jakub.Fruhauf	&mdash;
pirateid Jakub.Hevera	&mdash;
pirateid Jakub.Chlupacek	&mdash;
pirateid Jakub.Klemsa	&mdash;
pirateid Jakub.Knapek	RU71YvRb4SCk61Akx7o8bDw9QgR5jXPo7DNmQHD/pSE [zobrazit]
pirateid Jakub.Kosecek	&mdash;
pirateid Jakub.Kotal	&mdash;
pirateid Jakub.Kotula	&mdash;
pirateid Jakub.Michalek	rn2m6QS1hHGrPHnj60Y7NjWFnmz+o9FELkwJVAFgUAk [zobrazit]
pirateid Jakub.Nepejchal	wCA4wv731nwxeCl2KZkmyEg/JGDgX8nKQy4fJZaWsyY [zobrazit]
pirateid Jakub.Petros	&mdash;
pirateid Jakub.Plechac	hEaZuvOTx22bVDDszvOmhXHEfGq2A3d9sYPSzFL8LoM [zobrazit]
pirateid Jakub.Pribyl	&mdash;
pirateid Jakub.Samborsky	&mdash;
pirateid Jakub.Smid	qQnrJKtQEDh7MOrVdNFsl5ZCsAtpQ/10lfY92JV0EBE [zobrazit]
pirateid Jakub.Sobocik	&mdash;
pirateid Jakub.Tomanec	&mdash;
pirateid Jakub.Vaclavovic	&mdash;
pirateid Jakub.Vavra	&mdash;
pirateid Jakub.Vojta	&mdash;
pirateid Jakub.Vontroba	sOBoFJoKgtvpRW4DgtdpVOQ/OEOXm9Hh1jH6BBcuNnE [zobrazit]
pirateid Jakub.Zach	&mdash;
pirateid Jana.Belecova	1nGdmGts4uNa6jT/OE5SFNB3LAkbAvaEzW4RYMsDfbA [zobrazit]
pirateid Jan.Adam	&mdash;
pirateid Jan.Adamec	jiBH7oOfPmh8OsOsdEohtfDWA3beEM1f+nhnHD1nuG8 [zobrazit]
pirateid Jana.Hladova	ZrhSabeZBaZcdWaoYQAzx/elA9iHnH+ARgx7YFpx5Pc [zobrazit]
pirateid Jana.Horka	T0QW2IcBWs7RNw2vgqB6hQqVX/CZlHhgRDuzIP4XUh8 [zobrazit]
pirateid Jana.Kabelova	nycuTYtA0NlXJ83D/8fg419xeRDeZz/tUm7fAkpiU5k [zobrazit]
pirateid Jana.Kolarikova	&mdash;
pirateid Jana.Komrskova	&mdash;
pirateid Jan.A.Kozak	&mdash;
pirateid Jana.Leitnerova	ZGOvJLLM1zjZR7OLbapEnESz5+okiK8t/8pMYa3cRxc [zobrazit]
pirateid Jana.Patkova	&mdash;
pirateid Jana.Schlegelova	4zPVFHlGssE2DPmSBo5cgjG+Al6mM5xSACVntLmTeIE [zobrazit]
pirateid Jana.Skopalikova	nJi8pEYANwLC3Z4OhgClTp6nw0Ats8i8hLQzpBsgCLA [zobrazit]
pirateid Jana.Syrovatkova	&mdash;
pirateid Jana.Tomsikova	&mdash;
pirateid Jan.Bartko	qiZ9FkbQ0iQk+2zQ9LzFnVqDWnChlaBzI3l50HZ8DWQ [zobrazit]
pirateid Jan.Bednar	ZSA8LUH4Qlp2OthNomfG835U1L6o3sn7osCo0Uc7AMk [zobrazit]
pirateid Jan.Bednarik	1hVTPpQVV6EWwyPiJZXngim2R2CAwSpqE9LrT/mZb6U [zobrazit]
pirateid Jan.Bernhardt	&mdash;
pirateid Jan.Brandejs	qn/+oQ5PFGRQh/OZpRClxbjzCroOU0JamReIjw9DQxQ [zobrazit]
pirateid Jan.Buksa	GTfnLtui1pY1y3Q8w+IWi3vnTfE5ADcMcek4wYZRIeY [zobrazit]
pirateid Jan.Fiser	KkqYvBXk+droIk2plNig9NTGWu5fuVXuUYLbSEYDtuY [zobrazit]
pirateid Jan.Hamal.Dvorak	&mdash;
pirateid Jan.Havel	UZJBwU0mr1097RbK0oilJVwagneEAdGkHNrkVjYUqeI [zobrazit]
pirateid Jan.Heller	&mdash;
pirateid Jan.Hoder	&mdash;
pirateid Jan.Horn	&mdash;
pirateid Jan.Hosek	LSUiIMrfc28MCLPAImQPR/y/YCJvP2Fo0mfk7M85/no [zobrazit]
pirateid Jan.Hrubes	4OSo1rewpzyF+Z3mJZlDUzgdHmt4avbtckmwYdmtJT4 [zobrazit]
pirateid Jan.Hutter	4ajIOzdmbPKXf/KV0cKWwuTtTLdDd8K1JO4t1k5a/Eo [zobrazit]
pirateid Jan.Jurik	&mdash;
pirateid Jan.Juza	W5aaMhjBlaBldlL4pXuDHnqex+qXCmA1WJGrJmIbi/o [zobrazit]
pirateid Janka.Michailidu	&mdash;
pirateid Jan.Kasik	E5sCy5K4Ky4EWoW+9uG0x+STxdzTIbxxFrPcoKQLO6Q [zobrazit]
pirateid Jan.Kerber	&mdash;
pirateid Jan.Kohler	&mdash;
pirateid Jan.Kolator	73KhBaR96cU5k6KVv6nIt/xJZ8GkEsrTOVfzQJHyj/Y [zobrazit]
pirateid Jan.Korbel	1h2wgQNn7UXkQ+PF3lqriZAQPXqrXG/4qJn4ZTG5BZo [zobrazit]
pirateid Jan.Kotas	&mdash;
pirateid Jan.Koukolik	&mdash;
pirateid Jan.Koutny	&mdash;
pirateid Jan.Kranda	&mdash;
pirateid Jan.Kunc	VH4K7RJ4Te/Akj5USqoPbxWZ8UlU9O3I/exloz1TQ5Y [zobrazit]
pirateid Jan.Lehky	hlPUQgs9RCMFifRr0Q/+/AzU1GPqy6a2FoZaIRb3N90 [zobrazit]
pirateid Jan.Lejcko	&mdash;
pirateid Jan.Licka	6w6EvGsJ/WDTDWblgTFgS7q/lcxNfQDgXc47djBF+aE [zobrazit]
pirateid Jan.Lipavsky	nsUHAOu8HQr8VCUu2DZ/RHhhCESrAtezHjAH/y/ZymM [zobrazit]
pirateid Jan.Lisovsky	&mdash;
pirateid Jan.Lukasek	&mdash;
pirateid Jan.Lukavsky	&mdash;
pirateid Jan.Maixner	&mdash;
pirateid Jan.Mares	&mdash;
pirateid Jan.Mejsnar	I1xytHVLowD3Ie0bs6agGLgTr2MEFfgbDQ8tIZl4wZE [zobrazit]
pirateid Jan.Molic	&mdash;
pirateid Jan.Moravec	&mdash;
pirateid Jan.Mucka	&mdash;
pirateid Jan.Nezhyba	&mdash;
pirateid Jan.Novak	Hdhc9VKzNtVOWOvFFtZRp/OwLtFrBenIZhpQDHlyjI8 [zobrazit]
pirateid Jan.Podhajsky	/hNfPfI6N2IinpEwZDqRCuhuAPooSUipoYnG9pDinzs [zobrazit]
pirateid Jan.Polak	&mdash;
pirateid Jan.Pospisil	&mdash;
pirateid Jan.Posvar	iI6yad8xPOiLDUV3Jjh+TdrH4Jatq/ZNAwmvQ6NgixM [zobrazit]
pirateid Jan.Prachar	mQgIsgi8Cs+wKALvkM7Cfg5C7WPVxOiWVfe7HjGIE9M [zobrazit]
pirateid Jan.Pribramsky	&mdash;
pirateid Jan.Priessnitz	&mdash;
pirateid Jan.Prokop	UrSjnILNmKv3uCpx1hCJItbRYSQgwV+hjswq5u8sNjU [zobrazit]
pirateid Jan.Rakovsky	&mdash;
pirateid Jan.Rissky	&mdash;
pirateid Jan.Rosik	&mdash;
pirateid Jan.Skala	&mdash;
pirateid Jan.Spevacek	&mdash;
pirateid Jan.Stehlik	&mdash;
pirateid Jan.Sterba	v/Ejia+tdEwkPCy7Gig9Z5KALFpzbpoK0re5pMWhBh8 [zobrazit]
pirateid Jan.Suchanek	&mdash;
pirateid Jan.Tempel	NaO0FDu8bd+dZCkcPUb2H3hDIEVK2/geF/Swkbnmuik [zobrazit]
pirateid Jan.Tichavsky	QawHVNQrinAo3aCPFatdD6JgTgRIahSKHCT/cwgENNw [zobrazit]
pirateid Jan.Trnka	&mdash;
pirateid Jan.Zeman	&mdash;
pirateid Jarmila.Valesova	ZLcchyTJoDgsdLKslKhImY97P3WBukIP7HsUi6kKWak [zobrazit]
pirateid Jaromir.Barak	&mdash;
pirateid Jaromir.Beranek	&mdash;
pirateid Jaromir.Horky	GwrdLgaVC2PNuS9iJ4xH1JINsROljssUY9NkXYlpUlQ [zobrazit]
pirateid Jaromir.Slezak	&mdash;
pirateid Jaroslava.Lalova	&mdash;
pirateid Jaroslava.Narozna	xejcdN0ubyCmnbIAzq7Mw+rkt0uWrZc8oSaduwWueUY [zobrazit]
pirateid Jaroslava.Vatay	&mdash;
pirateid Jaroslav.Hansal	&mdash;
pirateid Jaroslav.Horejsi	K5jkFhVpzWOQWcxslRfq0okzKz6dAkdJSWHFo6TxC+I [zobrazit]
pirateid Jaroslav.Kamen	&mdash;
pirateid Jaroslav.Klimes	&mdash;
pirateid Jaroslav.Krejci	&mdash;
pirateid Jaroslav.Kucera	&mdash;
pirateid Jaroslav.Lainz	OTkJw0oYqKc13OH1AbgSJe5vgHYyK3cYgJKWsyxSzew [zobrazit]
pirateid Jaroslav.Nemec	1qVP1oFizpNaUbP9NGXVRzUgHDjr8H5fz08PbbHm318 [zobrazit]
pirateid Jaroslav.Sevcik	&mdash;
pirateid Jaroslav.Sida	&mdash;
pirateid Jaroslav.Takac	XXdDSZugAF5ZUpjv5NWWPFDG3996s15Fq61+BW1zeyI [zobrazit]
pirateid Jaroslav.Tomcala	&mdash;
pirateid Jaroslav.Vysoky	&mdash;
pirateid Jaroslav.Zaruba	c1shYJiwrgaHYcauBucAeYmHLJBCxKhWuUzBnq0thnk [zobrazit]
pirateid Jaroslav.Zejda	&mdash;
pirateid Jindra.Matlachova	&mdash;
pirateid Jindrich.Bartek	&mdash;
pirateid Jindrich.Cermak	TbRUVwinG/yx3B+ZodtarCf/HDv2h6DM6h0KhC3TGxQ [zobrazit]
pirateid Jindrich.Neuzil	&mdash;
pirateid Jindrich.Pavek	&mdash;
pirateid Jindriska.Sramkova	5a71an0zs7ByJwEfMLnTjktfpQZfoTCSfY5gk+iZ8Lk [zobrazit]
pirateid Jiri.Baudis	Ra9kw7eGkeG4aIvuCesBAR9Ce/M8ydeRus+pqOqCEPc [zobrazit]
pirateid Jiri.Belsan	&mdash;
pirateid Jiri.Beranovsky	&mdash;
pirateid Jiri.Berkovec	&mdash;
pirateid Jiri.Bruzek	&mdash;
pirateid Jiri.Demel	BwrK8REYYMKspl0/bYx8x1njkgj50VU+oczQWxjqtxQ [zobrazit]
pirateid Jiri.Dohnal	&mdash;
pirateid Jiri.Duchacek	Pedk97cO/ngznXIkheeIYLavbLAQHbL+SvflQ48eg/k [zobrazit]
pirateid Jiri.Hoskovec	aImtsCiR5d9pzUNfK1Mcgy67Nf6v5xOEdxtfyLawQzw [zobrazit]
pirateid Jiri.Hybek	&mdash;
pirateid Jiri.Chladek	LvLqWK9lG6YGuxxQfhT2EqGYcwbtf9D8lGPrmiOJd44 [zobrazit]
pirateid Jiri.Janecka	&mdash;
pirateid Jiri.Jansa	t7szjLjfq3HUL96Q0VQw1VKC8WP8Dlp7E9m3MsM76Bo [zobrazit]
pirateid Jiri.Jaros	&mdash;
pirateid Jiri.Kaderavek	&mdash;
pirateid Jiri.Kaderavek.sen	QQCxMpz/m2/kb3AwIWfu/Ya94mLeeUjmZN//E/vRsGs [zobrazit]
pirateid Jiri.Komrska	&mdash;
pirateid Jiri.Koudelka	MOJlfwxX1nDr6mbTS96ebb2uTP+vz0gbhmnTHW6rDZ0 [zobrazit]
pirateid Jiri.Kratky	&mdash;
pirateid Jiri.Lehejcek	DitgzGqybUEkZkeo2KUejF3sx8iAnhb1wasZyBHyTiw [zobrazit]
pirateid Jiri.Metod.Kassl	+Bim3Z/EXXZPl6in0oBzkGETqDQTH3jcVNk64sF2m5c [zobrazit]
pirateid Jiri.Mifka	&mdash;
pirateid Jirina.Ciprova	n8boypIJOYs6M0NOxfENGnz9Dcpx2V111L/pUx++Xgs [zobrazit]
pirateid Jiri.Najdenov	&mdash;
pirateid Jirina.Prochazkova	O1iE+lf0K8xctaUEU7VfaHLlE/E4JHrByHcXouTNhMk [zobrazit]
pirateid Jiri.Navratil	&mdash;
pirateid Jiri.Pek	Qu8KxRPW1A26q8EpS3oPfaG5K073vhCCM0RrA8SoOZg [zobrazit]
pirateid Jiri.Pertl	4HdYqtJnGcnQGgFlAcLfmMEliTq3YPk3M6NzlKbcG3Q [zobrazit]
pirateid Jiri.Princ	&mdash;
pirateid Jiri.Prouza	&mdash;
pirateid Jiri.Prymek	&mdash;
pirateid Jiri.Rajnoch	&mdash;
pirateid Jiri.Rezek	&mdash;
pirateid Jiri.Rotter	&mdash;
pirateid Jiri.Roubicek	&mdash;
pirateid Jiri.Snizek	Dqe0V4ZeGAWzlP6MyHJPeMncVxzqLatHxfUZGFyWRZc [zobrazit]
pirateid Jiri.Stastny	YCPwMS562i4dwH7drLceBsChApWDYyX6dB+sxbFyY4Q [zobrazit]
pirateid Jiri.Svrcek	&mdash;
pirateid Jiri.Ulip	uNNCeiAtMbO6WsAKwxFl060Mlurw/BKIpAUCsmYOtuA [zobrazit]
pirateid Jiri.Vyoral	&mdash;
pirateid Jitka.Nazarska	iCpSFUL/M/QF9wWmJDvWtxJllEfWoIQyQtVAdC+frXU [zobrazit]
pirateid Jitka.Novotna	shRXyEy3PkBsDY8nBx8C/ogR/hj5TeOd07Csqizw7/M [zobrazit]
pirateid Jitka.Vondrouskova	wl6Ven43yaXGDK2Wxkxsbi2Ab2vJPwLUB2ZrViGcCXE [zobrazit]
pirateid Josef.Bouse	&mdash;
pirateid Josef.Brecka	2IYKLldiK/1UsOCKBTABKLZfbHvLS182stOHf46Etns [zobrazit]
pirateid Josef.Janu	SRy+mzKugPAxEj86NkaYfAmTJlz7ZXaHVK9WmaudAL8 [zobrazit]
pirateid Josef.Kadlecek	rt81ubNsssJabxnLhCyG9qZepYKbZVLFKdy0fPnfXOs [zobrazit]
pirateid Josef.Kocourek	&mdash;
pirateid Josef.Korinek	&mdash;
pirateid Josef.Krajc	&mdash;
pirateid Josef.Kubat	4DRE2KwE5NRXLKIJA3HYxqDjZG4+XMx2J4sxZ7CgDm4 [zobrazit]
pirateid Josef.Kvasnicka	&mdash;
pirateid Josef.Pavlovic	bHNjmQ++q23gFbpb8Q3C7jsefkpEZHQywEap/KgX6eU [zobrazit]
pirateid Josef.Soumar	&mdash;
pirateid Josef.Spak	nvpA+9Op9oyo2/7rRpKgJnjidc+fq0MkM4rXho2Yd4o [zobrazit]
pirateid Josef.Ulehla	&mdash;
pirateid Josef.Vlach	tWjE4RNxpOHXmcBPx/F/5oMyf2s2PFosehisp9EfOyI [zobrazit]
pirateid Juraj.Halas	&mdash;
pirateid Kamila.Galikova	&mdash;
pirateid Kamil.Kubica	JDPyIiDR2f0dZUCT6zxURIAi7b5FbrKOTpAk1G6J1WQ [zobrazit]
pirateid Kamil.Pikal	XGn2JcshvoqWfRj7dZ9qBxJLVLCPKUTCbnb6as6p4Qw [zobrazit]
pirateid Kamil.Podlas	&mdash;
pirateid Karel.Ficenec	&mdash;
pirateid Karel.Kadlec	&mdash;
pirateid Karel.Kovarik	&mdash;
pirateid Karel.Maly	CQ99roePjNyehVPRzdYyS070mIH5yvlpp6LzLsF0yuk [zobrazit]
pirateid Karel.Nejedlik	jFLp6aHyRqV9cgWwh1sXKWcOfiAa3g6R9UXrmOJWzK4 [zobrazit]
pirateid Karel.Nykles	Rhg88XB6jXyw6y/p7L3NKHshQZO9XRdIxzhap4wVelk [zobrazit]
pirateid Karel.Ptacek	70hczzy5e6ozugOjiR955iLfPDeNmU3Ecp8Kw8wxeYY [zobrazit]
pirateid Karel.Stanek	t+BnQvHCIWa2hqyVA+hbPHWIjnh4fAtKnL9TD3cpGmc [zobrazit]
pirateid Karolina.Vejmelkova	laqrDPZiGNmhHrkA6/us7M/4gnWNNbYCPr3EX8C159M [zobrazit]
pirateid Karsten.Sachs	pyOpgsDaQl1lO/VEVhLaqrgtFMSmWapVIE+fCE0+XVc [zobrazit]
pirateid Katerina.Hulkova	&mdash;
pirateid Katerina.Jinova	55T+rQbYGzOEmPZrbnKSTECpAOCh72Bg8XJ0v0fUSds [zobrazit]
pirateid Katerina.Jirsova	&mdash;
pirateid Katerina.Pavlovicova	&mdash;
pirateid Katerina.Plchova	faj8Yw2sqX8Y4e9ORC3gLLa2+wvFx8iNdowCK+wjC5c [zobrazit]
pirateid Katerina.Stojanova	&mdash;
pirateid Katerina.Zavrska	&mdash;
pirateid Klara.Kocmanova	&mdash;
pirateid Kornelia.Gottmannova	&mdash;
pirateid Kristyna.Hlaskova	&mdash;
pirateid Kristyna.Znamenackova	&mdash;
pirateid Kuba.Smid	&mdash;
pirateid Kucera.Pavel	&mdash;
pirateid Kveta.Marikova	&mdash;
pirateid Lada.Kozminova	&mdash;
pirateid Lada.Peksova	D5ghHCzeLyKlBT1dBlW2fSvzg/6ZtHAMGQBM6wVxScA [zobrazit]
pirateid Ladislav.Dvorak	LCKPIqg/u14Kmiwp0ys8tT8EoKZGQs20JcXVaoR605Y [zobrazit]
pirateid Ladislav.Kos	&mdash;
pirateid Ladislav.Koubek	ALJfmDLdcRoARZ4qXjAb+gvgQ5FUITZFS7SjCWVX5hE [zobrazit]
pirateid Ladislav.Rajcan	&mdash;
pirateid Ladislav.Stalmach	&mdash;
pirateid Ladislav.Stanovsky	&mdash;
pirateid Ladislav.Tkaczyszyn	PbhqEwntC7lO/kPxQ9jynynAZBdZm2SrjpT67XyS724 [zobrazit]
pirateid Lenka.Cermakova	&mdash;
pirateid Lenka.Kozlova	&mdash;
pirateid Lenka.Spanihelova	&mdash;
pirateid Leonard.Varga	&mdash;
pirateid Libor.Adamek	&mdash;
pirateid Libor.Luzik	&mdash;
pirateid Libuse.Verisova	fq9d0R8Nf04xHWef76CvSJWVtXoXmvvUrytepKeHIVA [zobrazit]
pirateid Libuse.Vevodova	&mdash;
pirateid Linda.Berchinova	&mdash;
pirateid Linda.Kasparkova	&mdash;
pirateid Linda.Matuskova	5bpwTeeY0GO6qKMA5Dm5hiRhWukjODUWIqXdfQK8PdE [zobrazit]
pirateid Linda.Neubergova	oI5njiXIYQf24OD4FNiOHFtXrogxvQawoASY2b+ZWeo [zobrazit]
pirateid Ljuba.Polakova	&mdash;
pirateid Lubomir.Dolezal	&mdash;
pirateid Lubomir.Spacek	Ujc6HhB90D6eW2Wf8JEzsfXCSSBbwjbpn14BKqjzwR0 [zobrazit]
pirateid Lubomir.Vlcek	NybxqV6fKKPf4RPl+95ueTc+2OsM7MxJtuASb8i2lFw [zobrazit]
pirateid Lubos.Fuks	&mdash;
pirateid Lubos.Sedlak	/C4DhN6Yv2lktDCpSiAxGTRR+c15JtMO9X5TpcqR4wI [zobrazit]
pirateid Lucia.Sirinova	WEnJSAMfmvBNFvORXDdtZ0JpLvSmbQz/LfQaV2eEFOU [zobrazit]
pirateid Lucie.Krelinova	&mdash;
pirateid Lucie.Malikova	&mdash;
pirateid Lucie.Schwarzova	&mdash;
pirateid Lucie.Spacilova	gp/8fOb3vAibdvTk8+l2UVg8Ll3yfI3udaKiqlra1SA [zobrazit]
pirateid Lucie.Trckova	prtGatIbeIHtR9GVfGWGl9dYxwQEODOvDtJuNZEiD3I [zobrazit]
pirateid Lucie.Vadkerti	1MLRSAaCOD6e800Ql2NVdypL/KnmcUkNUJ4up2jm1xs [zobrazit]
pirateid Ludek.Blaha	Fuy+VYbUY+3Wt0QB6eIT6OCLIdDLC9N3gQVbNwEYALM [zobrazit]
pirateid Ludmila.Beutelova	El97CV9ICsrg7CtwCPF3WncvnIZqyH239HqlhR6sRrM [zobrazit]
pirateid Lukas.Adam	&mdash;
pirateid Lukas.Barton	&mdash;
pirateid Lukas.Blazej	Mu10Z1maLquTxv2VIru9oqi2VkEdvmVTZ7+IFaBomUU [zobrazit]
pirateid Lukas.Cernohorsky	OQZxfGosR1tugEpuS/Um3P08zhUxd6FdYqr/ZsGtP3E [zobrazit]
pirateid Lukas.Dubec	1xeVLEWZq+fCltQ6hmnut+WxMLVWB3nDiZOBagSFdtA [zobrazit]
pirateid Lukas.Findeis	&mdash;
pirateid Lukas.Fryzelka	PEvzAhAa7Fx49MLbWR3MUcNoJGvvk35kltfJi5HpbQc [zobrazit]
pirateid Lukas.Funk	&mdash;
pirateid Lukas.Hejduk	1xUJniTWLB5Kj8j3rjTf6csU4s3s2r4Xzl0+MEGbImI [zobrazit]
pirateid Lukas.Chlebik	&mdash;
pirateid Lukas.Jadlovsky	7EcAA/RA/WwWejHES6kxJBQopv8EpeDq3vs4TiwYWGU [zobrazit]
pirateid Lukas.Kolarik	&mdash;
pirateid Lukas.Kresta	&mdash;
pirateid Lukas.Kubicek	&mdash;
pirateid Lukas.Lev.Cervinka	xdniG0JXNQtJO1UYIjHUhuW5ZPjNOdhNQGGxzkYnrMU [zobrazit]
pirateid Lukas.Mamula	&mdash;
pirateid Lukas.Mares	Uyx97aMBXrlvTOpVYQ5V6l5LKl9CJEu2IgtKFopoGNk [zobrazit]
pirateid Lukas.Rysavy	&mdash;
pirateid Lukas.Vondrak	nNpoayYv2wOtlGtNZG2fhIKYELWNkBWSpJnDV2Jfy8E [zobrazit]
pirateid Lukas.Zykan	cdne5XfpxeK1rlmS6A4E6cVZeOMPiVn6zN8qrigLE/o [zobrazit]
pirateid Lydie.Bartosova	cDQIQQ11/WmJVEuwzbnTfc6CGSqQnwcaWwKP1VOLOFQ [zobrazit]
pirateid Magda.Dankova	r3ts+jofXCwLn/l+UjOL6+hMOGRuyWkXhueaEppm5+0 [zobrazit]
pirateid Magdalena.Mejzrova	RtzLvwbarU9bOEUfitW+3wgbSm6AhZwYZwn9Wv+i3s0 [zobrazit]
pirateid Magdalena.Valdmanova	njKQjq6pAHozRwjhICN072JE4lPz7nDfKDjz3RrxfUc [zobrazit]
pirateid Magdalena.Voldrichova	&mdash;
pirateid Magda.Lengalova	&mdash;
pirateid Marcel.Kolaja	OsuhPYvWMmCLnonaOdrGGG6Rzqi1vi4J9O1IaQr0nH0 [zobrazit]
pirateid Marcel.Palatas	BrJF/ygAR2qLJTcPQjRP3QDGxFgZFiuuoVPMdMhhzHo [zobrazit]
pirateid Marcel.Smrcka	&mdash;
pirateid Marcel.Zebrok	&mdash;
pirateid Marek.Blaha	4wSaUizpyQC3g0/AN7QQlX0cv05vjtulgHYlgIIFeI8 [zobrazit]
pirateid Marek.Cmiel	&mdash;
pirateid Marek.Forster	tRUAYMd6TUQO/PGarwm50C7vgsE6PtjGi1qf+Wsa2ig [zobrazit]
pirateid Marek.Habrun	&mdash;
pirateid Marek.Hanke	&mdash;
pirateid Marek.Hoschna	&mdash;
pirateid Marek.Houser	PwoPAS+buyx22T29jSU65LK2etDukQEtLeiWlE2u+sc [zobrazit]
pirateid Marek.Jurca	mEwiKxK+wYJ5RG9xNGWuRe8o9jT0AxI1ZMO2L1ekuJo [zobrazit]
pirateid Marek.Michalek	&mdash;
pirateid Marek.Necada	G559XVu5tay/SoZwqfcnE6aLFsiDNDGJSazBDFYLzJA [zobrazit]
pirateid Marek.Paris	6DB8cWqzYqflyoHdTYM54fHzUMZNkfRsQ4jj9z7NH5c [zobrazit]
pirateid Marek.Rebicek	&mdash;
pirateid Marek.Valko	&mdash;
pirateid Margita.Brychtova	&mdash;
pirateid Maria.Vasickova	&mdash;
pirateid Marie.Kurkova	&mdash;
pirateid Marie.Machalkova	&mdash;
pirateid Marika.Rehova	&mdash;
pirateid Mario.Pospisil	&mdash;
pirateid Marketa.Dreslova	&mdash;
pirateid Marketa.Gregorova	wImG0ZnzmklEZsK86vnUxhCt39z1XNgkknHrtpUGdZk [zobrazit]
pirateid Marketa.Monsportova	&mdash;
pirateid Marta.Oskerova	&mdash;
pirateid Marthas.Kucera	&mdash;
pirateid Martina.Halas.Vackova	&mdash;
pirateid Martin.Altschmied	&mdash;
pirateid Martin.Arden	rA7ZccvICqcG2c7E9xHOl/m3YlaHE16TMexzyKD344I [zobrazit]
pirateid Martina.Urbankova	v/lj69UIQ6UxqpaPIC+ayJ1LzdjXuprXmGgV0MamneU [zobrazit]
pirateid Martina.Vapenikova	&mdash;
pirateid Martin.Basta	&mdash;
pirateid Martin.Bohac	1C7n5tu+RMowmymu+gZZlQJA/YEYgoy0GWIl2g2Ur1A [zobrazit]
pirateid Martin.Burget	&mdash;
pirateid Martin.Cryo.Broz	&mdash;
pirateid Martin.Drbohlav	&mdash;
pirateid Martin.Duska	&mdash;
pirateid Martin.Foltyn	&mdash;
pirateid Martin.Fontana	&mdash;
pirateid Martin.Heinich	&mdash;
pirateid Martin.Herman	Qo/vaw0AH/PzWSFwZYN/SiD4LfknbFMKiW0miS87B6o [zobrazit]
pirateid Martin.Holub	&mdash;
pirateid Martin.Holzman	&mdash;
pirateid Martin.Hradela	TzGcJRwUa0GY/RibBE2mWwM0Y6RZpxezo3+E7KJ8drY [zobrazit]
pirateid Martin.Hrdlicka	&mdash;
pirateid Martin.Chour	&mdash;
pirateid Martin.Janko	wpXljyZlcHfWzwAXeMPKKLw4gwi7+arpa2/cde4m/rk [zobrazit]
pirateid Martin.Jiranek	&mdash;
pirateid Martin.Kacirek	&mdash;
pirateid Martin.Kakona	&mdash;
pirateid Martin.Kalina	ORY8UHX5SSFYegBT1QIdyx6LCwQQcmd6UdURv8Drz+Q [zobrazit]
pirateid Martin.Karel.Svetlik	TTwtvRd1bYPMl/uAWP3q/BKpKqUu8cg8Pilf09ZWs54 [zobrazit]
pirateid Martin.Kmec	&mdash;
pirateid Martin.Kucera	2nFycB1Groiz8Sjd7obHWbgxTeRFAENVwAFHcHc7hzg [zobrazit]
pirateid Martin.Latal	fbnnPR78solh88rs0r0JM0pI3xj4DymNqERqRu8yu68 [zobrazit]
pirateid Martin.Mareda	1l45+taEiUEDgyDqk2SqvZ3ERVS6JvnWt71j7jmn+r8 [zobrazit]
pirateid Martin.Martin	&mdash;
pirateid Martin.Morong	Ea6tw2xurVDvHFu82j0q78JWP0IscHOYbIy0q9BvgQI [zobrazit]
pirateid Martin.Muzikant	&mdash;
pirateid Martin.Picha	&mdash;
pirateid Martin.Polak	tIIR6aayWDx5z23V5MZi/UzX4r/YTqrDJ2XOpRaXB9Y [zobrazit]
pirateid Martin.Ptacek	vQ3E7WBzpjjQ4zxs2oae/HM3L1/0BCbRDKW3i0MmN2o [zobrazit]
pirateid Martin.Redr	plEF/2H5xWfTYyGlS3LSR+JZTn47/q0wH5rqVKofkwA [zobrazit]
pirateid Martin.Rejman	IgwsGD0dCuAQJ9ipJBKaoDYlcXwtV0cjmY1NfjIdmjk [zobrazit]
pirateid Martin.Saifrt	wXiRfZXMu991Vi+73BQLNYZmMoIwqI6KCgQgVA8feBY [zobrazit]
pirateid Martin.Semecky	&mdash;
pirateid Martin.Skapa	&mdash;
pirateid Martin.Smida	&mdash;
pirateid Martin.Stanek	&mdash;
pirateid Martin.Sterba	&mdash;
pirateid Martin.Strnad	&mdash;
pirateid Martin.Strupek	&mdash;
pirateid Martin.Suchan	+5KfzNE1y1pwIgy9kXFNV6i8OvzbJBNAbc5zxehO+l8 [zobrazit]
pirateid Martin.Sumerauer	&mdash;
pirateid Martin.Svadlenka	+UYggLiN6Finv8sM0zWAR2oVNLbrJNBU++AK8CgQ/Eo [zobrazit]
pirateid Martin.Valasek	h4RNMFxOhAutQ7aLyKMGTLrurORUPqJPW8wN4bbWRK4 [zobrazit]
pirateid Martin.Vit	sFfAlKipgikjptnQMjAM+N2dFfyQVhiNqnMUJ6SGT6I [zobrazit]
pirateid Martin.Vojta	&mdash;
pirateid Matej.Krajca	&mdash;
pirateid Matej.Mlcoch	&mdash;
pirateid Matej.Sandor	SThY3TbtBksQxL3xgRfIvEJkFw1SOEeSzYZglttrS+M [zobrazit]
pirateid Matej.Soukup	&mdash;
pirateid Michaela.Cerna	&mdash;
pirateid Michaela.Davidova	&mdash;
pirateid Michaela.Jagerova	&mdash;
pirateid Michaela.Kleslova	&mdash;
pirateid Michaela.Krausova	B1RHrYaVPM/FIQV+++Gr4U5IWfC8gL6YLgE5hDtoftg [zobrazit]
pirateid Michaela.Krupickova	9Gt6vNhTrBSgmnry+5DI2k1pvIX0UnQoWdlsQA0hzH4 [zobrazit]
pirateid Michaela.Schwarzova	pIlDf2Yg+YiLhEoUOedBbqwZnGp9X2SV+wtlmBJRSvg [zobrazit]
pirateid Michaela.Skokanova	iyWGdKHKj0qzRTO5NZnoAtBPziNsBIP+MKQRGYJh6oA [zobrazit]
pirateid Michaela.Vodova	9UZg+gzW1ZHs7hJA7OGVJ0Pc381f5nhUvuP6dnmZlKQ [zobrazit]
pirateid Michael.xChaos.Polak	&mdash;
pirateid Michal.Breskovec	n0yPb+pZCl0EoL7q68OZxwhL9LGKN9TSUgCGgxCf1M8 [zobrazit]
pirateid Michal.Ertl	s21ZQLPmNWiofHyX/K568q7SrrzQGOGwdwieUBr6WCM [zobrazit]
pirateid Michal.Gill	rXsWNOC7Ch0pWWyWyNrlzpn6ac2PzIezggVXLWyE0ng [zobrazit]
pirateid Michal.Hazlinsky	5piKo+rEIMY+PY7mgFnhev3nPO4Cm3I65Kw8EIaBgHE [zobrazit]
pirateid Michal.Horak	JYmLh6x5eXd0LMNXZblXhy5w5gPiwCQ5eLYJErEcIB0 [zobrazit]
pirateid Michal.Huml	&mdash;
pirateid Michal.Jokes	pTHGFJfAQJBchDTWvYA4oLqpKofHh73rgqq313r3Xjk [zobrazit]
pirateid Michal.Kalab	&mdash;
pirateid Michal.Ketner	NT0yzx/rPGVmw8yFovdLCW05bhXYYqzgb39YaagFIuM [zobrazit]
pirateid Michal.Klus	&mdash;
pirateid Michal.Koci	&mdash;
pirateid Michal.Kordik	&mdash;
pirateid Michal.Kovarik	&mdash;
pirateid Michal.Krivohlavy	&mdash;
pirateid Michal.Lupecka	&mdash;
pirateid Michal.Macek	PGYbGiA+Y5E101KYojGtD1iB1nsaOHAf+TGbfZc+Pao [zobrazit]
pirateid Michal.Marciniszyn	&mdash;
pirateid Michal.Novak	l1B1zY6FSX/QBnQZSUUhvrtfMgK3bauJieycGjafCX0 [zobrazit]
pirateid Michal.Prager	0Kn3HJ78qs/oLcRbUxFXqS62hbbHwQh6euGDkm7OeqA [zobrazit]
pirateid Michal.Reiter	&mdash;
pirateid Michal.Robousky	Oqm31cQwe68z9L9RWaj81NB7J4lLdFug7ir5Ur8+yAM [zobrazit]
pirateid Michal.Schwarzkopf	&mdash;
pirateid Michal.Soltys	qHvCUX7/+ZYVzkFjiRI5hi2cnF6JJdez8xEPs25S3JY [zobrazit]
pirateid Michal.Stepan	&mdash;
pirateid Michal.Tresl	&mdash;
pirateid Michal.Zachar	2iEsAYOXbexb1UZgqlaH6gu2vs3w0nCWazE6PeJWr8k [zobrazit]
pirateid Michal.Zak	&mdash;
pirateid Mikulas.Ferjencik	/kqxiwg05bJ7PdiH0cMm9NZTBWAow7B+KVdZxC/IvPY [zobrazit]
pirateid Mikulas.Peksa	&mdash;
pirateid Milada.Petrova	&mdash;
pirateid Milan.Dadourek	2czNQgG8pXaMezta6RzYuhCRNqnhTLrGV6sWlKnT5SI [zobrazit]
pirateid Milan.Fladr	&mdash;
pirateid Milan.Klajn	l4/aWC7LBZta0sfCj4kao1tJ3UGnIZ4tKDBXK3qLT9E [zobrazit]
pirateid Milan.Krch	&mdash;
pirateid Milan.Minarik	&mdash;
pirateid Milan.Nemec	M8ork9xzua8yfRzVpGnuLzW3ioSzVIvk9dqyzSkVz1U [zobrazit]
pirateid Milan.Strup	&mdash;
pirateid Milan.Zeleny	&mdash;
pirateid Milos.Kovar	&mdash;
pirateid Miloslava.Karfilatova	B8Lk3/h2PUJfj1DGkK+HVo3sbFxZ+50j4j3+YjI1UI4 [zobrazit]
pirateid Miloslava.Kolackova	&mdash;
pirateid Miloslav.Bim	&mdash;
pirateid Milos.Mrkvicka	&mdash;
pirateid Milos.Vlach	XGpex5Vi+f9qxyn6ZXpmsRfKDQudXn2n7Lzll/P4wNg [zobrazit]
pirateid Milos.Zmeskal	sL37/FUbl+EUezgz83I+GfGqCJPyl46qbmmPQPMNeg0 [zobrazit]
pirateid Milus.Kotisova	&mdash;
pirateid Miroslava.Macova	&mdash;
pirateid Miroslav.Barta	&mdash;
pirateid Miroslav.Caky	&mdash;
pirateid Miroslav.Foltyn	&mdash;
pirateid Miroslav.Hasa	&mdash;
pirateid Miroslav.Kodada	&mdash;
pirateid Miroslav.Kraus	&mdash;
pirateid Miroslav.Sirina	1kSma1DXEq5GdRhp63QJB9yLqnMxr4pzj9uhxZ4Dy9s [zobrazit]
pirateid Miroslav.Vanacek	n/gIXb9JTXFJ3GXoZ2xwG9lRzvL/dtEvuC0AI9OXJ9c [zobrazit]
pirateid Monika.Spilkova	&mdash;
pirateid Nadezda.Jureckova	&mdash;
pirateid Nela.Moudra	&mdash;
pirateid Nikola.Indrova	zk99UV9yqE1yf4npf8merAfSCt4vpBeyL+gqm3DFfVg [zobrazit]
pirateid Nikola.Stepankova	BgGoHvp/OOxW+p8q2or1D1risZ1zkbdK5uKUsEiPlgM [zobrazit]
pirateid Nikol.Marhounova	WRQcK9buWccla4W6YtrXkkdXfsTaYenCokFQD9YD/90 [zobrazit]
pirateid Oldrich.Maca	&mdash;
pirateid Olga.Richterova	jVU1EMVNDvmEMxi4SiriqfZAd2ZvdOYvxJoXeEUBheQ [zobrazit]
pirateid Olga.Sklenarova	2ZB6t0O6bPNK1MtPkcM26/lc/TNXMKF+0v+Brr3pgcY [zobrazit]
pirateid Ondra.Marek	&mdash;
pirateid Ondrej.Barton	33duRG4xM6obimsNaq68+cvhKrYzBE66Dg8M5bGIyII [zobrazit]
pirateid Ondrej.Cesik	OVww74u9VAK/Jryt4DWgvwCHgV0ZMmrQ7GSM5qkq50k [zobrazit]
pirateid Ondrej.Elfmark	&mdash;
pirateid Ondrej.Hanus	&mdash;
pirateid Ondrej.Horak	&mdash;
pirateid Ondrej.Hrdy	&mdash;
pirateid Ondrej.Chrast	&mdash;
pirateid Ondrej.Kallasch	&mdash;
pirateid Ondrej.Karas	3AXI2BErw2BWl0pv926IPA+rRIhgMS34TeJTD+mQzfU [zobrazit]
pirateid Ondrej.Kliment	uxHXMtFeboX3MS0jqyy1Kyh+OV5zPgGyX9XBYuSVQ8g [zobrazit]
pirateid Ondrej.Kolek	&mdash;
pirateid Ondrej.Kotas	&mdash;
pirateid Ondrej.Leseticky	&mdash;
pirateid Ondrej.Moravcik	6uWI1vH4zd7khZxBy5lfouq6Dk721TGud07R3g2vHdI [zobrazit]
pirateid Ondrej.Netocny	gD+7SkD7xigLnfRIzRUChFO5/dEIXDFbbaC8b4rbTJw [zobrazit]
pirateid Ondrej.Novosad	y+WHxwLHdXNufO0EhdgOHyo3jA5vCAQNqJS1kN/cKB8 [zobrazit]
pirateid Ondrej.Polansky	&mdash;
pirateid Ondrej.Profant	&mdash;
pirateid Ondrej.Rucka	&mdash;
pirateid Ondrej.Skorka	&mdash;
pirateid Ondrej.Skvor	&mdash;
pirateid Ondrej.Spendlicek	TPwD5FRh7e1769k7t8b1+dqaUDTiph4E2SKg6U5Tw7E [zobrazit]
pirateid Ondrej.Topinka	1gNpBAxI+SFyRNwsR0KRczr2CBnUZWgLXkt3cSWzVsA [zobrazit]
pirateid Ondrej.Tuma	w32rY/LPGKbmLxDRmSXiobPg16vAmmigS2W7n27LtPY [zobrazit]
pirateid Ondrej.Vichta	VCWhgyoZ+/sFxOLx2ee1acxdAJN23i1DP3S2Z6aunFk [zobrazit]
pirateid Ondrej.Vitecek	&mdash;
pirateid Ondrej.Vojta	wMOeCxS0Ft5tqzHdDei6nRN85/YBTZx+a4rM1WeOpNw [zobrazit]
pirateid Otakar.Petr	&mdash;
pirateid Patrick.Zandl	&mdash;
pirateid Patrik.Marcian	&mdash;
pirateid Pavel.Beznoska	&mdash;
pirateid Pavel.Bosak	&mdash;
pirateid Pavel.Bulicek	&mdash;
pirateid Pavel.Cisar	&mdash;
pirateid Pavel.Franc	Jf94HZtWrGhCnYqRPDFSMRh1vh8ZtwACXBxFF4jEl2g [zobrazit]
pirateid Pavel.Gazda	&mdash;
pirateid Pavel.Hajek	SL+mkrI8CNtQ7jadAbYuggxLKd7sYdbZ0vDYpL/LjO4 [zobrazit]
pirateid Pavel.Kasik	&mdash;
pirateid Pavel.Klapste	&mdash;
pirateid Pavel.Knezik	BIDVDSZe1gRY2BXjS9U2UTF4WI2P6iIt54332jHgOX0 [zobrazit]
pirateid Pavel.Korizek	00555ADhCh7XdlYtTTau+y837IL73lolybZl8tEe97E [zobrazit]
pirateid Pavel.Kralicek	&mdash;
pirateid Pavel.Kucera	&mdash;
pirateid Pavel.Kviz	&mdash;
pirateid Pavel.Majtan	/xIQK327yappbALisTQSCUDCsYd+oC71uHA3ss4ic04 [zobrazit]
pirateid Pavel.Mendl	&mdash;
pirateid Pavel.Mladek	&mdash;
pirateid Pavel.Moravec	63fshtMDSvqM/i7NblzxEJ1y928SSMFS3ujgbsU7sBA [zobrazit]
pirateid Pavel.Musil	&mdash;
pirateid Pavel.Nazarsky	&mdash;
pirateid Pavel.Nevrkla	&mdash;
pirateid Pavel.Opatril	&mdash;
pirateid Pavel.Reimann	&mdash;
pirateid Pavel.Slezak	eggyuLWZOnJ5+Sl/CTGIKlJ9x73K62NA9YSHwrx8GLM [zobrazit]
pirateid Pavel.Sramek	OZ6nzRRIdJ7Qy/apPxAJxz/XpHtm4zrev67w/fDfqXE [zobrazit]
pirateid Pavel.Sramhauser	&mdash;
pirateid Pavel.Stepanek	3aFXfMh44674qOxmJu1iJYt0Dutu53xYCvKhl3YEhiI [zobrazit]
pirateid Pavel.Tauer	&mdash;
pirateid Pavel.Tucek	&mdash;
pirateid Pavel.Volk	22VEOBtbHDkpxwCepeEgcUrC0jDhVY907ojzVtNYrm0 [zobrazit]
pirateid Pavel.Vrbicky	&mdash;
pirateid Pavla.Marusova	&mdash;
pirateid Petra.Dolezelova	&mdash;
pirateid Petra.Fohlerova	&mdash;
pirateid Petra.Kujinek.Polodnova	&mdash;
pirateid Petra.Minarova	&mdash;
pirateid Petra.Smutna	AN9TlWsndc6GomqD6zLeTXTeIQYW9uc6gCg7nTEHObk [zobrazit]
pirateid Petra.Zamecnikova	&mdash;
pirateid Petr.Balaz	&mdash;
pirateid Petr.Bartonek	&mdash;
pirateid Petr.Benes	&mdash;
pirateid Petr.Bukvic	8UmdLdvcnmSB/f7cKvzaKU+0HOkXReAJNm178q6uxgA [zobrazit]
pirateid Petr.Daubner	Ejc8GhxPX+40aYoEbSsksvak5Jg103tfB3RZ7lUyHag [zobrazit]
pirateid Petr.Fiebiger	&mdash;
pirateid Petr.Hejny	&mdash;
pirateid Petr.Chapcak	&mdash;
pirateid Petr.Chmelar	&mdash;
pirateid Petr.Jedelsky	&mdash;
pirateid Petr.Jelinek	&mdash;
pirateid Petr.Jenik	&mdash;
pirateid Petr.Kalafatic	&mdash;
pirateid Petr.Kapounek	7dZbuyGP9IcQ/w6MPS7dEw7Vz6jcPZfBeh98qmCiQhs [zobrazit]
pirateid Petr.Karel	aEycEBfkdN4Apfw4h3ZiKXqeCIT/c3Ca+Qbn8udJYuc [zobrazit]
pirateid Petr.Karlik	&mdash;
pirateid Petr.Kolar	&mdash;
pirateid Petr.Kopac	HkQlHkFcBHFhYi5g0lAPrfDd1Y39QcBmBZKoOk1l98U [zobrazit]
pirateid Petr.Kopecny	&mdash;
pirateid Petr.Kricensky	fHZ9N2/dsImojLCqcc7U6WQChKqL4gbdUsMRRb3ArRw [zobrazit]
pirateid Petr.Lysek	HjuWSA6lMJMXZJzW+Aqh/xgZOIIOIvX2Mubqi17RuJM [zobrazit]
pirateid Petr.Mazur	&mdash;
pirateid Petr.Nemecek	&mdash;
pirateid Petr.Polacek	1/vjTvvIdQmX3jqJ4SFts48FiOYUW3A6DDNwCn2+sU4 [zobrazit]
pirateid Petr.Prochazka	zvgYwnB7vLtHvbOqD1rw2TnyNTnQGFx9QTnWzvbodjY [zobrazit]
pirateid Petr.Rysler	/T18CzJ6gI9YxF6o1RNqchqkb5F17iZVa4LGxlI51aE [zobrazit]
pirateid Petr.Simecek	&mdash;
pirateid Petr.Simon	&mdash;
pirateid Petr.Sousek	&mdash;
pirateid Petr.Springinsfeld	TSRSAMqU9UnxRY2ITsfDkIL00LV1Ls1OKYionoAdb9g [zobrazit]
pirateid Petr.Steinbauer	&mdash;
pirateid Petr.Stoklasa	KWFPcjp23WgBDbXFxIsMkPAlR7h1W2gp19cfh7xxm/8 [zobrazit]
pirateid Petr.Sukal	&mdash;
pirateid Petr.Syrovy	&mdash;
pirateid Petr.Tkadlec	AE+9tKUlyTHmpF2XAXY9tIH91cYi8jnaoc89b1CdRxA [zobrazit]
pirateid Petr.Tresnak	Xcg2S2fGjuUKusUacEsHr9lvX8WeUCzF+iLVQeIXdpw [zobrazit]
pirateid Petr.Vileta	iMnzmkRJlXkfrwvH9rS0jG0NcAMib0QmdTDLOVIHMcQ [zobrazit]
pirateid Petr.Vlasak	&mdash;
pirateid Petr.Vyhnal	&mdash;
pirateid Petr.Zamecnik	&mdash;
pirateid Radek.Cernohous	HL/CCtgfm/55PWq9vgjjmJgA7eoZ3g0ZSE+Rx1Ffros [zobrazit]
pirateid Radek.Holodnak	&mdash;
pirateid Radek.Holomcik	&mdash;
pirateid Radek.Krejci	cJKuu2d9o8b62RBkvDA3mmDQMGwPRhSw+QhWBWEeHpk [zobrazit]
pirateid Radek.Lavicka	&mdash;
pirateid Radek.Letko	&mdash;
pirateid Radek.Namestek	&mdash;
pirateid Radek.Nohavica	fwreYj1r0kbuUJd98smmQ7lt5aPWPiV8qRf2hJYdKyc [zobrazit]
pirateid Radek.Oborny	&mdash;
pirateid Radek.Simkanic	&mdash;
pirateid Radek.Sis	&mdash;
pirateid Radek.Strouhal	JLV8d2WOOjnTXQvRvyO9WqRlykeK2z12XbhG4gE5cvs [zobrazit]
pirateid Radek.Vojtek	SJ6wvXjLttfpn93Gw8OaKLzBG06yAfGwv0j6mzXanJ8 [zobrazit]
pirateid Radim.Racek	&mdash;
pirateid Radim.Studeny	&mdash;
pirateid Radovan.Poor	&mdash;
pirateid Radovan.Trojancik	&mdash;
pirateid Renata.Zdarkova	&mdash;
pirateid Rene.Mayer	&mdash;
pirateid Rene.Vanecek	&mdash;
pirateid Robert.Cuma	&mdash;
pirateid Robert.Kavka	&mdash;
pirateid Robert.Magni	NAw6lAHUEZCN+n1WGcT3Cap2jJaSih0hoAPVdxV7Rx4 [zobrazit]
pirateid Robert.Miksa	&mdash;
pirateid Robert.Rames	&mdash;
pirateid Robert.Sip	&mdash;
pirateid Robert.Srejma	&mdash;
pirateid Robin.Jiran	&mdash;
pirateid Roland.Martin	&mdash;
pirateid Romana.Klimesova	PDndrnc+vQVMu4xt/1H41/AoP/xv/cKDQSYaq98judg [zobrazit]
pirateid Romana.Korosi	dQfaVyZhYZvZI2W46j3zJceSETp8i/3xo97F3FhTB74 [zobrazit]
pirateid Romana.Nemcova	&mdash;
pirateid Roman.Glaser	&mdash;
pirateid Roman.Kubat	&mdash;
pirateid Roman.Kucera	jBAwMLO02GmN+lhFWi3dVgP9GaGE7F+i7JVJcHbORds [zobrazit]
pirateid Roman.Kummel	&mdash;
pirateid Roman.Mazur	&mdash;
pirateid Roman.Novacek	egqGjH5SJvtgJt/jarK3tfospmiKmZLCXdy5q44dp3Q [zobrazit]
pirateid Roman.Pasek	xHHEGEC8ExAfwuaVQhyFcHHP2oI7mTKKSZ8G8BoqwcY [zobrazit]
pirateid Roman.Sedlacek	&mdash;
pirateid Roman.Stosek	&mdash;
pirateid Roman.Zak	&mdash;
pirateid Rostislav.Matuska	&mdash;
pirateid Rostislav.Reha	&mdash;
pirateid Rudolf.Spotak	rzFVuhtbbNTOLac1IzfuK9QOq/hoFBsbMRx6WOfXQng [zobrazit]
pirateid Samuel.Machat	&mdash;
pirateid Sandra.Lamichova	&mdash;
pirateid Sara.Hornekova	&mdash;
pirateid Sara.Zavrelova	&mdash;
pirateid Sarka.Rousova	JJ9qrLtvW4i3CF31W7oixIM7E3U4d1q/h7fQnyYbVaM [zobrazit]
pirateid Simona.Bartova	bTqr07GcXRD9IpeRxb18tK7MEdqaGx8AQJf0f3Ie59w [zobrazit]
pirateid Simon.Barczi	e0/h2wFBkNXpH2MFdle+FpayX/5XGaFfkFunDonVOT0 [zobrazit]
pirateid Simon.Foucek	&mdash;
pirateid Simon.Kostadinov	&mdash;
pirateid Sona.Pechova	&mdash;
pirateid Stanislav.Haviar	&mdash;
pirateid Stanislav.Hranicka	&mdash;
pirateid Stanislav.Neuman	&mdash;
pirateid Stanislav.Pesek	&mdash;
pirateid Stanislav.Podojil	ug7hjjRTsh2wJ0S2s4fDWu9Q/qaCwRUJ4Lzz7bYlJGU [zobrazit]
pirateid Stanislav.Rezek	&mdash;
pirateid Stanislav.Senkyr	&mdash;
pirateid Stanislav.Stipl	8OzN4cMUw/d7VCbX8D+e7ETUhYraYb7CYaaSPC0wrS4 [zobrazit]
pirateid Stepan.Drtina	&mdash;
pirateid Stepan.Jelinek	&mdash;
pirateid Stepan.Strebl	lK6l8lVrKtp1K6GoGBURiOi5xqzjzUj0If76iiSBTxU [zobrazit]
pirateid Stepan.Voda	&mdash;
pirateid Tadeas.Kral	Yfb/YKSYzOVIMNj3n4CNuv3SYCwZiP2vymKHHET9VqA [zobrazit]
pirateid Tereza.Flakova	nwl2AiGbrckqQsuwuU5tmyfXoCslBoMtVGrDFUCj5+4 [zobrazit]
pirateid Tereza.Hubackova	/tkEUPpi1SsswgijR5AZACqisBQJ36jbi5qiCNXRoi0 [zobrazit]
pirateid Tereza.Vovesova	RYoL9UHPon9prvi/HoepojSt70LjI/ia5mKw7l/38es [zobrazit]
pirateid Tibor.Vansa	vYd6FNgkfp+KuoPVs07SaHlSP2kd01+VrkaLyRhYxv0 [zobrazit]
pirateid Tomas.Bouda	4OJeIPN1FPDFFja0kzMyp5XgOFg4pH1aXvWZL4rpskI [zobrazit]
pirateid Tomas.Cabla	sMk+PfljiV3V0W+jIo7w9LTba73To2P3Xf0pVww41kQ [zobrazit]
pirateid Tomas.Dostalek	&mdash;
pirateid Tomas.Durco	&mdash;
pirateid Tomas.Dvorak	&mdash;
pirateid Tomas.Gottwald	shTgdTMK+NF1aB4aQHbXn9NZmJ5VhsrALNy3/GPeDdE [zobrazit]
pirateid Tomas.Holomel	dkywUocmQaOjM+BMfMjBCwrOaFXgoZhyyA3ArFxTFMM [zobrazit]
pirateid Tomas.Karlik	&mdash;
pirateid Tomas.Kolacny	&mdash;
pirateid Tomas.Kolomy	&mdash;
pirateid Tomas.Kovarik	&mdash;
pirateid Tomas.Krejci	&mdash;
pirateid Tomas.Kula	&mdash;
pirateid Tomas.Lenard	&mdash;
pirateid Tomas.Machacek	&mdash;
pirateid Tomas.Marik	&mdash;
pirateid Tomas.Martinek	W9Kpaiu11Q3X5TMgz2RBjOkY3aMKG1AOflhzCAxc8ls [zobrazit]
pirateid Tomas.Murnak	VBfhpkcuFm5TfYaKxvYdPI9J7QvFP0fEV0r1jmBuq5A [zobrazit]
pirateid Tomas.Partl	&mdash;
pirateid Tomas.Pastircak	phh71SQoaQsEFn7VPpdIRB1IyRczT75NpNuWDskLILA [zobrazit]
pirateid Tomas.Pernica	If1yLMkoslj0WpASbkInU38WoHtnaWoWawIxHIwZ3Mk [zobrazit]
pirateid Tomas.Posekany	&mdash;
pirateid Tomas.Prochazka	&mdash;
pirateid Tomas.Rozkopal	&mdash;
pirateid Tomas.Rubinstein	&mdash;
pirateid Tomas.Semenec	&mdash;
pirateid Tomas.Solar	&mdash;
pirateid Tomas.Svoboda	&mdash;
pirateid Tomas.Tison	&mdash;
pirateid Tomas.Trcka	PaDas/fJaV8b5abpv4imrJGMIdmU6yzqXohyFv24UAo [zobrazit]
pirateid Tomas.Unger	mSkJM0/ZKlsPtYypeirbkTDK3TLgOIXfvAK2F14Gm3Y [zobrazit]
pirateid Tomas.Valek	mH315rxNtbBuDi4wtuZwGLB8oarqwPM5ahmVpz7CN8I [zobrazit]
pirateid Tomas.Veselka	&mdash;
pirateid Tomas.Vich	&mdash;
pirateid Tomas.Vymazal	&mdash;
pirateid Tomas.Weidisch	&mdash;
pirateid Tomas.Zmuda	&mdash;
pirateid Vaclav.Boucek	&mdash;
pirateid Vaclav.Doubrava	&mdash;
pirateid Vaclav.Fortik	yAZdcjni/OOSSZI/nXcOhiyeuASuV2RWTocwdzpm6X4 [zobrazit]
pirateid Vaclav.Honzl	&mdash;
pirateid Vaclav.Hrdlicka	&mdash;
pirateid Vaclav.Klecanda	&mdash;
pirateid Vaclav.Kubaljak	&mdash;
pirateid Vaclav.Michalec	&mdash;
pirateid Vaclav.Schwarz	&mdash;
pirateid Vaclav.Urban	&mdash;
pirateid Vaclav.Vislous	DKfhVijsDJMd0XsgzOHvsyrQXdge+o/H5wzEB0bfXyU [zobrazit]
pirateid Vaclav.Zidek	m8K6O2E1viBJmR2pELXRJltaiq3mX90wrqxFFcqnjtU [zobrazit]
pirateid Vaclav.Zouzalik	&mdash;
pirateid Vendula.Machova	&mdash;
pirateid Vendula.Polanova	BaQK0ApVccrbe1j4y+krz/9F8iuuI+EulEFKNfnA4mA [zobrazit]
pirateid Vera.Marusiakova	RzBPyFef8h8QFx7QR7FPDWYOCQRL2EWxroa/kpMsm1Y [zobrazit]
pirateid Veronika.Kovarova	&mdash;
pirateid Veronika.Murzynova	XoLcGr6awY+vutawtb/kND0TZAdmf3iXn0dg5OeH+1g [zobrazit]
pirateid Veronika.Nguyenova	X9rht0CYufbrwsLftS6XPgv3I2pDCEDRWzR7JSZWvdE [zobrazit]
pirateid Veronika.Nurnbergerova	&mdash;
pirateid Veronika.Skoupilova	&mdash;
pirateid Veronika.Stepkova	&mdash;
pirateid Veronika.Vavrinova	DUrgDb11O/mgvQQKSA1VUdbv+vXdHvqzNOX2X0q7f7w [zobrazit]
pirateid Viktor.Derka	u/KaB5CaVABg1QR0wdd+JH28UhH8DSOz/7u9ipDI/uQ [zobrazit]
pirateid Viktor.Krutina	naTICjc2ZIMTI0FuPniVAl+PToJCaFODHtdhsIl/SuE [zobrazit]
pirateid Viktor.Mahrik	&mdash;
pirateid Viktor.Piorecky	&mdash;
pirateid Viktor.Tichak	MwZzUkJU3/8/aMA99YvoRshYcfGABnxqSecavdbEMfA [zobrazit]
pirateid Vilem.Marsik	&mdash;
pirateid Vita.Hocek	&mdash;
pirateid Vitezslav.Adamec	&mdash;
pirateid Vitezslava.Rosecka	&mdash;
pirateid Vitezslav.Hocek	&mdash;
pirateid Vitezslav.Repka	UD0N6bO64ykXQeLypxSqOW3RFU3cbkjx8wawVRMIVCE [zobrazit]
pirateid Vit.Jurasek	YqQ+kVtWnCZLVoNaMmWHPgMZHfttKt03JsyYu7NEBj4 [zobrazit]
pirateid Vit.Rous	wj7nBZt62ibtpK1ibzY89FgJN1BDDgS36jGa+Gs83B8 [zobrazit]
pirateid Vit.Simral	&mdash;
pirateid Vit.Zacek	qsIwzMkjVMTs+24LLhqggLM2Ltj5nF8tKVXSlaLvpKw [zobrazit]
pirateid Vladan.Hyl	&mdash;
pirateid Vladimira.Emingerova	&mdash;
pirateid Vladimira.Sykorova	cJQVqUXURWfp8rul0e7lyXvIEgN3heqjyeRF12OoamU [zobrazit]
pirateid Vladimir.Dubovy	vC4iqMJ4v0i0h/YxSu9dTZGYUcafNVflJt3bqzXNCCM [zobrazit]
pirateid Vladimir.Charvat	&mdash;
pirateid Vladimir.Koudela	&mdash;
pirateid Vladimir.Kubala	&mdash;
pirateid Vladimir.Malinsky	&mdash;
pirateid Vladimir.Schulz	&mdash;
pirateid Vladimir.Sraier	CydvxneIPTgOm5O8+bT5JU+ld6YFCLFgIhMG7vWl0XA [zobrazit]
pirateid Vladimir.Vapenik	h3s+G52vIEaWH/el/0OT4F9kQ21dQeUEuj4nYu+y4uE [zobrazit]
pirateid Vladimir.Vlach	&mdash;
pirateid Vladislava.Smith	&mdash;
pirateid Vladislav.Forman	&mdash;
pirateid Vlastimil.Bednarik	OQkzE4fv50s4gD95+vQroKS3vspFGnURowqEqWcI3bw [zobrazit]
pirateid Vojtech.Ertl	&mdash;
pirateid Vojtech.Jirsa	x1FfYYEZ/Hz5tcQdb5134mZedkNOWJ2R2cZDXq2ooWQ [zobrazit]
pirateid Vojtech.Karban	THk8jUWndupaw4gtSWFTlGHV+rp9tMv2Cj5ylbiZJPU [zobrazit]
pirateid Vojtech.Nezval	&mdash;
pirateid Vojtech.Pikal	9PHHXkRQLwnLkVPiedvgR5j/2TlelMqLdiDRZI9gmds [zobrazit]
pirateid Vojtech.Sazel	&mdash;
pirateid Vojtech.Voparil	&mdash;
pirateid Vratislav.Krejcir	94kjuukRchfk0Lx19sGiVNuPAQnV+TwUX8T5+VaJgmY [zobrazit]
pirateid Yveta.Martinkova	zDUPEGKMTk7mvpq1mmNIKzPRM1QfGvrT96rKgsZ8pNg [zobrazit]
pirateid Zbynek.Janoska	MVNnrd+Jco64f19QsEqbVW4ownrlsMaa1sJzFdtUdRw [zobrazit]
pirateid Zbynek.Konvicka	ghlpx+1JPI7ZhohitppHXkFYF9nd7OtP2osuon19lCU [zobrazit]
pirateid Zbynek.Miklik	&mdash;
pirateid Zbynek.Spalt	&mdash;
pirateid Zdenek.Brejsa	&mdash;
pirateid Zdenek.Hess	&mdash;
pirateid Zdenek.Hrib	/Er0LybP2k42/7PEsII0Xj/pQkt0ci07qQvAEt4YyYY [zobrazit]
pirateid Zdenek.Kops	NNz9ETB3cDHpAYq9kS7eeQnccHRkhQk2PO2QFiBJTQs [zobrazit]
pirateid Zdenek.Kubala	uBEuNf7IlaxT87NwJEZ8okuivm80tUTYjvlKHf2UQxM [zobrazit]
pirateid Zdenek.Lajbner	/H9nHipTUPzrW1Cv2bNCDKu1VKGBtT9VgYfeHOTbP1A [zobrazit]
pirateid Zdenek.Matych	&mdash;
pirateid Zdenek.Pech	&mdash;
pirateid Zdenek.Rozprym	ufH9Y+Upa7vGUEG5TrVtj75HYevhzR5Y+mjyczGDtWs [zobrazit]
pirateid Zdenek.Stepanek	&mdash;
pirateid Zdenek.Tresnak	+/wU3N4rsVBWJD+NAXOTtiRp35EMUn9H7NZz/LgRkII [zobrazit]
pirateid Zdenek.Tros	t+OFzzhhgqwoDJiLjYYS7u3HyjfjwmQve8NosIe8KzA [zobrazit]
pirateid Zdenek.Zak	&mdash;
pirateid Zuzana.Bohmova	&mdash;
pirateid Zuzana.Drazdova	UZkvvRlfHIZGKBBK9uRziuy5GHVvSv34Xl1kMOda87M [zobrazit]
pirateid Zuzana.Jichova	&mdash;
pirateid Zuzana.Klusova	&mdash;
pirateid Zuzana.Kudlackova	/9IXNVeMwOid1I/mVM3u7svLUWgRkmQIWiMmAHD/lBk [zobrazit]
pirateid Zuzana.Novosadova	rDnOagIKZ6SVSkoVzh5SpjbJjhUEMxKrKmG9/5Sn++k [zobrazit]
pirateid Zuzana.Tomkova	&mdash;
pirateid Zuzana.Ujhelyiova	jsGpjQ6F1YbkWOrAz5Zww/2gWrYB7bQPLltVVXgcSuc [zobrazit]
